NO ./texture/north.xpm
SO ./texture/south.xpm
WE ./texture/west.xpm
EA ./texture/east.xpm


F 22,125,9
C 25,34,189


            1111111111111111111111111
            1000000000110000000000001
    1011000001110000000000001
1001000000000000000000001
        111111111011000001110000000000001
100000000011000001111111111111111
11110111111111011100011110001
11110111111111011101020010001
11000000110101011100010010001
10000000000000001100010020N01
10000000000000001101010010001
1100000111010101111101111000111
11110111 1110101 101111010001
11111111 1111111 111111111111
