NO ./texture/bricks.xpm
SO ./texture/gravel.xpm
WE ./texture/water.xpm
EA ./texture/mud.xpm


F 22,125,9
C 25,34,189

11111111111111111111111111111111111111111111111111
10000101000100100000000010010000100010100001000011
10010000010000101011100010000111001000101010001001
10100011101010000100001000101000001100001000010101
10001100001001011000101111001000010010000100100001
11010000100101000010010000110110100001110110101001
10001000101000110000100110000000100100000001001001
10101011000010001110101001100100101011101100100011
10101000100101100001001000011000101000000010010001
10000100010000011000001010000100101000011010100101
10001011000111000111101000110010001011100010101001
10101000101000010000011101001001010000000010101101
10001010100000001010001001010000011010001001000001
10111100111111101001101010001011100001000100101001
10001001000000001000001000100100000101001010100011
11001010000100100111010010110010010001000010100001
10101000010000010000000100001001001010010100100101
10101100000100011110101001000100101000010100110001
10100010111001100000101000100010001000111010001001
10111010000010000110101010011001100110010000001001
10000010010000001001001001000100010001010010100001
10100100010001110001000100100011010101100101010001
10000110011010000100001010001000010100001000000101
11110000100100100011100001010101101000000100010101
10000001000010100100011001010010000000010110100101
10100110010000101001000101010000100111100001001001
10001000001100001010010110001011010000001001010001
10010010010011101000100000101000001100100100010001
10000010100000010010011100001110010010010110100011
11101001000111000100100010100001011001000001000101
10010001001000100000101001011001000000001100010001
11000100001010011110100101000000111000000010101001
10000010010011000001010101001111000001110010000011
10000010010000011100000100100000011100000000000001
10001100011110100011001010101000100010101111101111
11010010100000101000000010010001001000100000010001
10000010001001001000111101001010100011011001000101
10101011100010010100000000101000100100000001111001
1000010001010001000S100100100111001000010010000001
10001001010001001110001001010000001010100010100001
10010010001100100001010101001001001001000010000011
10100010010000110001010000001001000001010101010101
11001100000001000110001011000101010010001000010101
10010000101110011000100100100101111100101011100001
10010010100000100000110010010000010000001000010001
10010001011111111100001001001011000100001101001001
10010100000000100011010010001000100110000010000101
10011011110100101000100100110100111001111100101001
10000000000100001000001000000000000000000000001001
11111111111111111111111111111111111111111111111111
